02222222222022222222220
04000200002020000200020
02000200002020000200020
02222222222222222222220
02000201000000010200020
02222201111011110222220
00000200001010000200000
00000201111311110200000
00000201000100010200000
11111211011111011211111
00000201000000010200000
00000201111111110200000
00000201000000010200000
02222222222022222222220
02000200002020000200020
02220222222222222202220
00020202000000020202000
02222202222022220222220
02000000002020000000020
02222222222222222222220